______________________________
_                            _
_                            _
_L.....R................L...._
_L                      L    _
_......R..........L.........._
_                 L          _
_                 L          _
_..L...........L........R...._
_  L           L             _
_..L...........L........R...._
_  L           L             _
_........L..............R...._
_        L                   _
_............................_
